10,10,10,90,1
70,10,70,90,1
130,10,130,90,1
190,10,190,90,1
10,10,190,10,1
10,90,190,90,1